#_______________________________________________________#
#_______________________________________________________#
#_______________________________________________________#
#_______________________________________________________#
#_______________________________________________________#
#_______________________________________________________#              
#_______________________________________________________#
#_______________________________________________________#
#_________EEEEEE________________________________________#
#EEEEEEEEEEEEEEEEEEEEEEEEEEEEEEEEEEEEEEEEEEEEEEEEEEEEEEE#