#_______________________________________________________#
#_______________________________________________________#
#_______________________________________________________#
#_______________________________________________________#
#_______________________________________________________#
#_______________________________________________________#              
#_______________________________________________________#
#_______________________________________________________#
#EE_______EEEEEE________________________________________#
#EEEEEEEEEEEEEEEEEEEEEEEEEEEEEEEEEEEEEEEEEEEEEEEEEEEEEEE#